R 1000 700

NO ./textures/redbrick.xpm
SO ./textures/wood.xpm
WE ./textures/mossy.xpm
EA ./textures/stone.xpm
S ./textures/sprites/barrel.xpm
F 51,51,51
C 0,235,255


111111
1000N1
100001
102001
100001
100001
101001
100001
100001
100001
111111