R 768 1068 
NO ./textures/sand.xpm
SO ./textures/stone.xpm
WE ./blue.xpm
EA ./textures/red_brick.xpm
S ./textures/hitler.xmp
F 51,51,51
C 102,204,255

        11111111
1111111111000001
1000000001100001
1000000001100001
1000000000000001
1011200000000001
1000100000000001
1020000000000001
1111111111111111