R 768 1068
NO ./textures/sand.xpm
SO ./textures/stone.xpm
WE ./blue.xpm
EA ./textures/red_brick.xpm
S ./textures/hitler.xmp
F 51,51,51
C 102,204,255

        11111111
1111111111000001
10000000011N0001
1000000001100001
1000000000000001
10112000000000011111111
10001000000000000000001
10200000000000011111111
1111111110111111
        101
        111