R 1000 700

NO ./textures/redbrick.xpm
SO ./textures/sand.xpm
WE ./textures/mossy.xpm
EA ./textures/stone.xpm
S ./textures/sprites/barrel.xpm
F 51,51,51
C 0,0,65


111111
100001
100001
10N001
100001
100001
101001
100001
100001
100001
111111