
R 555 555
NO ./textures/stone.xpm
SO ./textures/stone.xpm
WE ./textures/stone.xpm
EA ./textures/stone.xpm
S ./textures/stone.xpm
F 220,100,0
C 250,30,0
11111
1S001
10001
11111
