R 768 1068
NO ./textures/sand.xpm
SO ./textures/stone.xpm
WE ./textures/blue.xpm
EA ./textures/red_brick.xpm
S ./textures/hitler.xpm
F 51,51,51
C 102,204,255

11111111111111111111111111111111111
10000000000100000011110000111111111
10000001000100000000000110111111111
11111001000101110010000010111111111
    1001000001111110001111111111211
    11000110011    1100000000000001
    11110110011    1111111111111101
       1211001                  101
        1  1001      1          101
            10111111121111111111101
            10000000000000000000001
            11111111111011111111111
11111111    11111111111011111111111
100000001   11111111111011111111111
100000001   11111111111011111111111
10000001111111111111111011111111111
100000000000000000000000011111111111
10001111111111111111111011111N11111
 10000001    1111111111011111111111
11110001    11111111111011111111111
11100001   11111111111011111111111
100000001   11111111111011111111111
100000001  111111111111011111111111
111111111 1000000000000011111111111
          1011111111111011111111111
          1000000000000111111111111
           1222220222221
           1222220222221
           1000000000001
           1000002000001
           1111111111111
           1
