     R       						   		 	 1000   	  	 	  	700		 	 	
	 	NO  	 	./textures/redbrick.xpm 	 	 		 	 
 	 		 	 	 	 	 SO 	 	 	 	 	 	 	   	 ./textures/wood.xpm 	 	 	
 		 	 	 	WE 	 	 	   			 	./textures/mossy.xpm	 	  
 	 	 			 	 EA   	 	    	 		 	./textures/graffiti.xpm	 	 	 
 	 	 	 	  	 		S  	 	 	 	     ./textures/sprites/caballeroBlack_1.xpm 	 	 
F 255,0,0
C        0,0,255




111111
1E0021
100001
100001
100001
100001
101001
100001
100001
100001
121121
111111
