R 1080 720
NO tests/textures/grey.xpm
SO tests/textures/grey.xpm
WE tests/textures/whitestone.xpm
EA tests/textures/whitestone.xpm

S tests/textures/sprite/42.xpm
F 0,60,0
C 150,255,255

        1111111111111111111111111
        1000000000110000000000001
        1011000001110000000200001
        1001000000000000000000001
111111111011000001110000000N00001
100000000011000001110111111111111
11110111111111011100000010001
11110111111111011101010010201
11000000110101011100000000001
10002000000000001100000010001
10000000000000001101010010001
1100000111010101111101111000111
11110111 1110101 101111000001
11111111 1111111 111111111111
