R 700 400  
NO brick.xpm
SO dirt.xpm
EA stone.xpm
WE wood.xpm
S brice_sprite.xpm
C 106,176,76
F 83,92,104
  11111111  1111111111111111
  10000001111000001000000001
  10020000000000001000000001
  1000000111100000100000000111111111
  11111111  100000100020000000000201
            100000100000000100000001
111111111111100011111110000100000001
120000000002000000000000000111111001
100000010000000000000000020000001001
100000010000100000000000000000001001
100000210000111100111100000002001001
1000111111111  1001  100000000000001
10001          1001  111111011111111
10001          1001       101
10001111111111110011111111101111111
10001000000000000000002000000000001
100000000000000000000000000000200W1
11111111111111111111111111111111111