R 800 400
NO tests/textures/grass.xpm
SO tests/textures/brownstone.xpm
WE tests/textures/grass.xpm
EA tests/textures/whitestone.xpm
S tests/textures/sprite/42.xpm

F 225,30,0
1111111111111111111111111
1000000000110000000000001
1011000001110000002000001
100100000000000000000000111111111
111111111011000001110000000N00001
100000000011000001110111111111111
11110111111111011100000010001
11110111111111011101010010201
11000000110101011100000000001
10002000000000001100000010001
10000000000000001101010010001
11000001110101011111011110001
11110111111100000000011000001
11111111111111111111111111111

